ERVY-LE-CHATEL 	 MISC
Marché du Livre 	 MISC
Rencontres 	 LOC
Ervy-le-Châtel 	 LOC
Reconnaître 5 sauvageonnes comestibles 	 MISC
Les Ombelles 	 LOC
Sortie au départ d’AIX-EN-OTHE 	 MISC
Sortie au Musée Colette 	 MISC
Château de Guédelon 	 LOC
Club des Anciens 	 ORG
Aix 	 LOC
BOUILLY 	 ORG
Marché de Noël 	 MISC
Comité des fêtes 	 ORG
ERVY-LE-CHATEL 	 MISC
Récital de Piano 4 mains 	 MISC
Matthieu Normand 	 PER
Nicolas Collinet 	 PER
Halle Circulaire 	 LOC
Villa de l'Extra 	 LOC
http://villa-de-l-extra.skyrock.com/ 	 MISC
BERULLE 	 LOC
Randonnée 	 LOC
Bérulle 	 PER
BOUILLY 	 ORG
Téléthon 	 ORG
CHAOURCE 	 LOC
Concert d’orgue 	 MISC
Paul Breisch 	 PER
cathédrale de Luxembourg 	 LOC
Cabaret itinérant 	 MISC
Festival en Othe 	 MISC
VAUCHASSIS 	 MISC
ERVY-LE-CHATEL 	 MISC
Sylvie Vernageau 	 PER
MARAYE-EN-OTHE 	 MISC
Feux de la Saint-Jean 	 MISC
Animations musicales 	 MISC
Maraye 	 PER
Tous 	 LOC
RACINES 	 LOC
Soirée 	 LOC
France 	 LOC
Russie 	 LOC
Philippe Borecek 	 PER
Ivan Netchiporko 	 PER
Ervy-le-Châtel 	 LOC
ESTISSAC 	 LOC
Fête du Cochon 	 MISC
place Caroline 	 LOC
PALIS 	 ORG
Boule Palisienne 	 MISC
Fête du tilleul centenaire 	 MISC
PUISEAUX 	 MISC
Promenade 	 LOC
Akadêmia 	 LOC
Musée du Cidre 	 LOC
Largentier)à 19 h. 	 LOC
ESSOYES 	 LOC
Exposition 	 MISC
M. Monnet Pierre 	 PER
Pays d’Armance 	 LOC
Ours 	 LOC
Renoir 	 PER
BOUILLY 	 ORG
Journées du Patrimoine 	 MISC
Saint Laurent 	 PER
Commission de la Culture 	 ORG
MAROLLES-SOUS-LIGNIERES 	 LOC
Méchoui 	 MISC
AUXON 	 ORG
Vide grenier 	 MISC
AFCA 	 ORG
BERULLE 	 LOC
Espace Jean Musy 	 LOC
Scène ouverte 	 MISC
PALIS 	 MISC
Boule Palisienne 	 MISC
ESTISSAC 	 LOC
Rando Voirloups 	 LOC
Estissac 	 LOC
Cyclo Club Othéen 	 ORG
COUSSEGREY 	 LOC
Stage 	 MISC
Univers 	 MISC
Soi 	 LOC
Renseignements 	 LOC
LIGNIERES 	 LOC
Chantier 	 LOC
Les Ombelles 	 LOC
SORMERY 	 ORG
Café Surprise : pratique artistique et chansons 	 MISC
Couvent de l’Orée Contact 	 LOC
ERVY-LE-CHATEL 	 MISC
l’Atelier de Sylvie Vernageau 	 MISC
