Saint-Jean-de-Maurienne 	 LOC
Le Figaro 	 ORG
Paul Vallier 	 PER
place Notre-Dame 	 LOC
rue de Strasbourg 	 LOC
boulevard Diderot 	 LOC
Gabi Heinze 	 PER
Olkaloo 	 LOC
Chroniques 	 MISC
La course du mouton sauvage 	 MISC
Kafka 	 PER
Au sud de la frontière 	 MISC
Afrique 	 LOC
Ethiopie la Somalie 	 LOC
Arabie 	 LOC
Cavalaire Pardigon 	 LOC
les Besse 	 PER
Aden 	 LOC
de France 	 LOC
Agüero 	 PER
lycée Arago 	 LOC
Reuilly 	 LOC
Diderot 	 PER
