ERVY-LE-CHATEL 	 MISC
Marché du Livre 	 MISC
Rencontres 	 LOC
Organisée 	 LOC
« Ervy-le-Châtel 	 LOC
Les Ombelles 	 ORG
AIX-EN-OTHE – Sortie 	 MISC
Musée Colette 	 LOC
Château de Guédelon 	 LOC
Club des Anciens 	 MISC
Aix 	 LOC
BOUILLY 	 ORG
Marché de Noël 	 MISC
Comité des fêtes 	 ORG
ERVY-LE-CHATEL 	 MISC
Récital 	 MISC
Piano 4 	 MISC
Matthieu Normand 	 PER
Nicolas Collinet 	 PER
Halle Circulaire 	 LOC
Villa 	 PER
Extra 	 LOC
BERULLE 	 LOC
Randonnée 	 PER
Une seconde vie pour des arbres 	 MISC
» Départ 	 MISC
Bérulle 	 LOC
BOUILLY 	 ORG
Téléthon 	 PER
CCAS 	 ORG
Concert 	 ORG
Paul Breisch 	 PER
cathédrale de Luxembourg 	 LOC
Festival 	 MISC
Othe 	 LOC
VAUCHASSIS 	 MISC
ERVY-LE-CHATEL 	 MISC
Sylvie Vernageau 	 PER
Tarif 	 LOC
Réservations 	 LOC
MARAYE-EN-OTHE 	 MISC
Feux de la Saint-Jean 	 MISC
Animations musicales 	 MISC
Maraye Pour Tous 	 MISC
RACINES 	 ORG
Soirée « 	 LOC
France 	 LOC
Russie 	 LOC
Philippe Borecek 	 PER
Ivan Netchiporko 	 PER
« Ervy-le-Châtel 	 LOC
ESTISSAC 	 MISC
Fête du Cochon 	 MISC
place Caroline 	 LOC
PALIS 	 ORG
Concours d’été organisé 	 ORG
Boule Palisienne 	 LOC
Fête du tilleul centenaire 	 MISC
EAUX 	 ORG
PUISEAUX 	 MISC
Promenade 	 LOC
Akadêmia 	 ORG
Musée du Cidre 	 LOC
Largentier)à 	 MISC
Renseignements 	 ORG
ESSOYES 	 MISC
M. Monnet Pierre 	 PER
Pays d’ 	 LOC
Renoir » 	 PER
BOUILLY 	 ORG
Journées du Patrimoine 	 ORG
Saint Laurent 	 PER
Commission de la Culture 	 ORG
Méchoui 	 LOC
AUXON 	 ORG
Vide 	 PER
BERULLE 	 LOC
Jean Musy 	 PER
Scène 	 PER
PALIS 	 ORG
Concours d’été organisé 	 ORG
Boule Palisienne 	 LOC
ESTISSAC 	 MISC
Rando Voirloups 	 PER
VVT 	 ORG
Estissac 	 LOC
Cyclo Club 	 ORG
COUSSEGREY 	 ORG
Stage 	 MISC
l’Univers 	 MISC
Soi 	 LOC
Chantier 	 LOC
Les Ombelles 	 ORG
SORMERY 	 ORG
Café Surprise 	 PER
Couvent de l’Orée Contact 	 LOC
ERVY-LE-CHATEL – Stage 	 MISC
Sylvie Vernageau 	 PER
Tarif 	 LOC
Réservations 	 LOC
