ERVY-LE-CHATEL 	 MISC
Marché du Livre à la salle des fêtes 	 MISC
Rencontres 	 MISC
Organisée 	 MISC
Ervy-le-Châtel 	 LOC
LIGNIERES 	 LOC
Reconnaître 5 sauvageonnes comestibles 	 MISC
Les Ombelles 	 LOC
AIX-EN-OTHE 	 LOC
Sortie au Musée Colette 	 MISC
Château de Guédelon 	 LOC
Club des Anciens 	 ORG
Aix 	 LOC
BOUILLY 	 ORG
Marché de Noël 	 MISC
Comité des fêtes 	 MISC
ERVY-LE-CHATEL 	 MISC
Récital de Piano 4 mains 	 MISC
Matthieu Normand 	 PER
Nicolas Collinet 	 PER
Halle Circulaire 	 LOC
Villa de l'Extra 	 PER
http://villa-de-l-extra.skyrock.com/ 	 PER
BERULLE 	 LOC
Randonnée 	 MISC
Une seconde vie pour des arbres » Départ 	 MISC
Bérulle 	 PER
BOUILLY 	 ORG
Téléthon au foyer familial 	 MISC
CCAS 	 LOC
CHAOURCE 	 LOC
Concert d’orgue 	 MISC
Paul Breisch 	 PER
cathédrale de Luxembourg 	 LOC
Cabaret 	 LOC
Festival en Othe 	 MISC
VAUCHASSIS 	 MISC
ERVY-LE-CHATEL 	 MISC
Stage d’Aquarelle 	 MISC
Sylvie Vernageau 	 PER
MARAYE-EN-OTHE 	 MISC
Feux de la Saint-Jean 	 MISC
Animations musicales 	 MISC
Maraye 	 LOC
Tous 	 LOC
RACINES 	 ORG
Soirée « 	 MISC
France 	 LOC
Russie 	 LOC
Philippe Borecek 	 PER
Ivan Netchiporko 	 PER
Ervy-le-Châtel 	 LOC
ESTISSAC 	 LOC
Fête du Cochon 	 MISC
place Caroline 	 LOC
PALIS 	 ORG
Boule Palisienne 	 LOC
LIGNIERES 	 LOC
Fête du tilleul centenaire 	 MISC
Renseignements 	 LOC
PUISEAUX 	 LOC
Promenade 	 LOC
Akadêmia 	 ORG
Musée du Cidre 	 LOC
Largentier)à 19 	 LOC
ESSOYES 	 LOC
Exposition permanente 	 MISC
M. Monnet Pierre 	 PER
Pays d’Armance 	 LOC
Ours 	 LOC
Renoir 	 PER
BOUILLY 	 ORG
Journées du Patrimoine 	 MISC
Saint Laurent 	 PER
Commission de la Culture 	 ORG
MAROLLES-SOUS-LIGNIERES 	 LOC
Méchoui 	 LOC
AUXON 	 LOC
AFCA 	 LOC
BERULLE 	 LOC
Espace Jean Musy 	 LOC
Scène 	 PER
PALIS 	 ORG
Boule Palisienne 	 MISC
ESTISSAC 	 LOC
Rando Voirloups 	 LOC
VVT 	 MISC
Estissac 	 LOC
Cyclo Club Othéen 	 ORG
COUSSEGREY 	 MISC
Stage 	 MISC
Univers 	 LOC
Soi 	 LOC
Renseignements 	 LOC
LIGNIERES 	 LOC
Chantier 	 PER
Les Ombelles 	 LOC
SORMERY 	 MISC
Café Surprise 	 MISC
Couvent de l’Orée Contact 	 LOC
ERVY-LE-CHATEL – Stage d’Aquarelle à l’Atelier 	 MISC
Sylvie Vernageau 	 PER
